# added postag entries
#-------------------------------------------------------------------------------
# Do not add words here, but report them to languagetool@taaltik.nl
#-------------------------------------------------------------------------------
voldane	voldoen	WKW:VTD:VRB
doorgegane	doorgaan	WKW:VTD:VRB
ingegane	ingaan	WKW:VTD:VRB
nagedane	nadoen	WKW:VTD:VRB
nagegane	nagaan	WKW:VTD:VRB
overgegane	overgaan	WKW:VTD:VRB
paarrijden	paarrijden	WKW:INF:ZNW:HET
toegegane	toegaan	WKW:VTD:VRB
uitgedane	uitdoen	WKW:VTD:VRB
voorafgegane	voorafgaan	WKW:VTD:VRB
voorbijgegane	voorbijgaan	WKW:VTD:VRB
voorgedane	voordoen	WKW:VTD:VRB
voorgegane	voorgaan	WKW:VTD:VRB
voortgegane	voortgaan	WKW:VTD:VRB
weggedane	wegdoen	WKW:VTD:VRB
ontgane	ontgaan	WKW:VTD:VRB
losstaanden	losstaan	WKW:ODW:MRV:DE_
miss-wet-T-shirtverkiezing	miss-wet-T-shirtverkiezing	ZNW:EKV:DE_
ANP-fotograaf	ANP-fotograaf	ZNW:EKV:DE_
APV-vergunning	APV-vergunning	ZNW:EKV:DE_
APV-vergunningen	APV-vergunning	ZNW:MRV:DE_
Agnesschool	Agnesschool	ZNW:EKV:DE_
Ajaxbestuur	Ajaxbestuur	ZNW:EKV:HET
Ajaxlogo	Ajaxlogo	ZNW:EKV:HET
Amerikareis	Amerikareis	ZNW:EKV:DE_
Amerikareizen	Amerikareis	ZNW:MRV:DE_
Antoniushoeve	Antoniushoeve	ZNW:EKV:DE_
Arabisch-nationalistisch	Arabisch-nationalistisch	BNW:STL:ONV
Belgisch-Lotharingen	Belgisch-Lotharingen	ZNW:MRV:DE_
Bijbelgenootschappen	Bijbelgenootschappen	ZNW:MRV:DE_
Bijbelwetenschappen	Bijbelwetenschappen	ZNW:MRV:DE_
Bondsdagpresident	Bondsdagpresident	ZNW:EKV:DE_
Bondsdagverkiezingen	Bondsdagverkiezing	ZNW:MRV:DE_
Bondsdagvoorzitter	Bondsdagvoorzitter	ZNW:EKV:DE_
Bosnisch-Servisch	Bosnisch-Servisch	BNW:STL:VRB
Bosnisch-Servische	Bosnisch-Servische	BNW:STL:VRB
Disneyfiguren	Disneyfiguur	ZNW:MRV:DE_
Disneyfiguur	Disneyfiguur	ZNW:EKV
Disneyfiguurtje	Disneyfiguur	ZNW:EKV:VRK:HET
Disneyfiguurtjes	Disneyfiguur	ZNW:MRV:VRK:DE_
Dommelstreek	Dommelstreek	ZNW:EKV:DE_
Eenheidsvakcentrale	Eenheidsvakcentrale	ZNW:EKV:DE_
Elleboogkerk	Elleboogkerk	ZNW:EKV:DE_
Erasmusproject	Erasmusproject	ZNW:EKV:HET
Erasmusprojecten	Erasmusproject	ZNW:MRV:DE_
GGZ-instellingen	GGZ-instellingen	ZNW:MRV:DE_
Geerpolder	Geerpolder	ZNW:EKV:DE_
Geraardsbergenaar	Geraardsbergenaar	ZNW:EKV:DE_
Haarlemmermeerder	Haarlemmermeerder	ZNW:EKV
Heinekenconcern	Heinekenconcern	ZNW:EKV:HET
Hillegersberg-Schiebroek	Hillegersberg-Schiebroek	ZNW:MRV:DE_
Hollywoodregisseur	Hollywoodregisseur	ZNW:EKV:DE_
Hollywoodregisseurs	Hollywoodregisseur	ZNW:MRV:DE_
Hollywoodstudio	Hollywoodstudio	ZNW:EKV:DE_
Hollywoodstudio's	Hollywoodstudio	ZNW:MRV:DE_
Homerusvertaling	Homerusvertaling	ZNW:EKV:DE_
Homerusvertalingen	Homerusvertaling	ZNW:MRV:DE_
Hondsruggebied	Hondsruggebied	ZNW:EKV:HET
IJsselstroom	IJsselstroom	ZNW:EKV:DE_
KNVB-competitie	KNVB-competitie	ZNW:EKV:DE_
KNVB-competities	KNVB-competitie	ZNW:MRV:DE_
Kamerontbindingen	Kamerontbinding	ZNW:MRV:DE_
Kamervergadering	Kamervergadering	ZNW:EKV:DE_
Kanaalpark	Kanaalpark	ZNW:EKV:HET
Kerkom-bij-Sint-Truiden	Kerkom-bij-Sint-Truiden	ENM:LOC:PTS
Kinderkruistocht	Kinderkruistocht	ZNW:EKV:DE_
Koranvertalingen	Koranvertaling	ZNW:MRV:DE_
Lieve-Vrouwebeeld	Lieve-Vrouwebeeld	ZNW:EKV:HET
Maasdorp	Maasdorp	ZNW:EKV:HET
Maasdorpen	Maasdorp	ZNW:MRV:DE_
Maasdorpje	Maasdorp	ZNW:EKV:VRK:HET
Maasdorpjes	Maasdorp	ZNW:MRV:VRK:DE_
Maasgeul	Maasgeul	ZNW:EKV:DE_
Maasgrind	Maasgrind	ZNW:EKV:HET
Maasstation	Maasstation	ZNW:EKV:HET
Maaszicht	Maaszicht	ZNW:EKV:HET
Mercedesmotor	Mercedesmotor	ZNW:EKV:DE_
Mercedesmotoren	Mercedesmotor	ZNW:MRV:DE_
NOS-hoofdredacteur	NOS-hoofdredacteur	ZNW:EKV:DE_
Nederlands-Duits	Nederlands-Duits	BNW:STL:VRB
Nederlands-Duitse	Nederlands-Duitse	BNW:STL:VRB
Nederlands-hervormd	Nederlands-hervormd	BNW:STL:ONV
Nederlands-hervormde	Nederlands-hervormde	BNW:STL:VRB
Noorder-Koggenland	Noorder-Koggenland	ZNW:EKV:HET
Noordoostpolders	Noordoostpolders	ZNW:EKV
Noordzeeschol	Noordzeeschol	ZNW:EKV:DE_
Noordzeezijde	Noordzeezijde	ZNW:EKV:DE_
Oder-Neissegrens	Oder-Neissegrens	ZNW:EKV:DE_
Oranjebaan	Oranjebaan	ZNW:EKV:DE_
Postbankrekening	Postbankrekening	ZNW:EKV:DE_
Rechtseenheidskamer	Rechtseenheidskamer	ZNW:EKV:DE_
Rekenkamercommissie	Rekenkamercommissie	ZNW:EKV:DE_
Rijksgebouwendienst	Rijksgebouwendienst	ZNW:EKV:DE_
Rijksluchtvaartdienst	Rijksluchtvaartdienst	ZNW:EKV:DE_
Rijksvoorlichtingsdienst	Rijksvoorlichtingsdienst	ZNW:EKV:DE_
Rijnhotel	Rijnhotel	ZNW:EKV:HET
Scheldeterrein	Scheldeterrein	ZNW:EKV:HET
Scheldevaart	Scheldevaart	ZNW:EKV:DE_
Senaatshoorzitting	Senaatshoorzitting	ZNW:EKV:DE_
Senaatsvergadering	Senaatsvergadering	ZNW:EKV:DE_
Senaatsverkiezing	Senaatsverkiezing	ZNW:EKV:DE_
Sluisbuurt	Sluisbuurt	ZNW:EKV:DE_
Statenvergadering	Statenvergadering	ZNW:EKV:DE_
Statenvergaderingen	Statenvergaderingen	ZNW:MRV:DE_
VVD-aanhang	VVD-aanhang	ZNW:EKV:DE_
Congresverkiezingen	Congresverkiezingen	ZNW:MRV:DE_
Volkswagenfabriek	Volkswagenfabriek	ZNW:EKV:DE_
Generaliteitsland	Generaliteitsland	ZNW:EKV:HET
Jeugdwerkgarantieplan	Jeugdwerkgarantieplan	ZNW:EKV:HET
Waalkanaal	Waalkanaal	ZNW:EKV:HET
Waalsprinter	Waalsprinter	ZNW:EKV:DE_
Waalwater	Waalwater	ZNW:EKV:HET
Waterland-Oudeman	Waterland-Oudeman	ZNW:EKV:DE_
Waddenvereniging	Waddenvereniging	ZNW:EKV:DE_
Wereldvoedselprogramma	Wereldvoedselprogramma	ZNW:EKV:HET
Wereldhandelscentrum	Wereldhandelscentrum	ZNW:EKV:HET
Wilhelminahoeve	Wilhelminahoeve	ZNW:EKV:DE_
Wilhelminaziekenhuis	Wilhelminaziekenhuis	ZNW:EKV:HET
Arbeidsvoorzieningsorganisatie	Arbeidsvoorzieningsorganisatie	ZNW:EKV:DE_
anti-Vietnamdemonstratie	anti-Vietnamdemonstratie	ZNW:EKV:DE_
Wagneruitvoeringen	Wagneruitvoeringen	ZNW:MRV:DE_
Assembleevergadering	Assembleevergadering	ZNW:EKV:DE_
Zuid-Afrikaans-Engels	Zuid-Afrikaans-Engels	BNW:STL:VRB
miss-wet-T-shirtverkiezingen	miss-wet-T-shirtverkiezing	ZNW:MRV:DE_
Activiteitenbesluit	Activiteitenbesluit	ZNW:EKV:HET
auteursopbrengst	auteursopbrengst	ZNW:EKV:DE_
auteursopbrengsten	auteursopbrengst	ZNW:MRV:DE_
Rijksarchiefschool	Rijksarchiefschool	ZNW:EKV:DE_
Wereldnatuurfonds	Wereldnatuurfonds	ZNW:EKV:HET
Oranjeaanvoerder	Oranjeaanvoerder	ZNW:EKV:DE_
Rampenidentificatieteam	Rampenidentificatieteam	ZNW:EKV:HET
watergezant	watergezant	ZNW:EKV:DE_
recombinant-DNA-technologieÃ«n	recombinant-DNA-technologie	ZNW:MRV:DE_
overziene	overzien	WKW:VTD:VRB
gebalkaniseerde	balkaniseren	WKW:VTD:VRB
gereleveerde	releveren	WKW:VTD:VRB
schadeloosstellen	schadeloosstellen	WKW:TGW:INF
vervoederen	vervoederen	WKW:TGW:INF
hypermetropen	hypermetroop	BNW:STL:MRV:DE_
Lierenaars	Lierenaar	ZNW:MRV:DE_
Noordzeeboerderijen	Noordzeeboerderij	ZNW:MRV:DE_
aangebeten	aanbijten	WKW:VTD:VRB
aangebraden	aanbraden	WKW:VTD:VRB
aangeboden	aanbieden	WKW:VTD:VRB
aangebonden	aanbinden	WKW:VTD:VRB
aangebroken	aanbreken	WKW:VTD:VRB
aanracen	aanracen	WKW:TGW:INF
aangeracet	aanracen	WKW:VTD:ONV
aanracet	aanracen	WKW:TGW:3EP
bauw	nabauwen	WKW:TGW:1EP:LOS
bauwt	nabauwen	WKW:TGW:3EP:LOS
bauwe	nabauwen	WKW:AWS:LOS
bauwen	nabauwen	WKW:TGW:INF:LOS
bauwde	nabauwen	WKW:VLT:1EP:LOS
bauwden	nabauwen	WKW:VLT:1EP:LOS
bevolen	bevelen	WKW:VTD:VRB
geboden	bieden	WKW:VTD:VRB
gebonden	binden	WKW:VTD:VRB
haast	hazen	WKW:TGW:3EP
omrankte	omranken	WKW:VTD:VRB
omvangen	omvangen	WKW:VTD:VRB
ontladen	ontladen	WKW:VTD:VRB
ontwonden	ontwinden	WKW:VTD:VRB
geraden	raden	WKW:VTD:VRB
schadeloosgesteld	schadeloosstellen	WKW:VTD:ONV
schadeloosgestelde	schadeloosstellen	WKW:VTD:VRB
schadeloosstelt	schadeloosstellen	WKW:TGW:3EP
terechtkan	terechtkunnen	WKW:TGW:3EP
toeleiden	toeleiden	WKW:TGW:INF
toegeleid	toeleiden	WKW:VTD:ONV
toegeleide	toeleiden	WKW:VTD:VRB
toegeleiden	toeleiden	WKW:VTD:ZNW:MRV:DE_
toeleidde	toeleiden	WKW:VLT:1EP
toeleidden	toeleiden	WKW:VLT:INF
toeleidend	toeleiden	WKW:ODW:ONV
toeleidende	toeleiden	WKW:ODW:VRB
toeleidt	toeleiden	WKW:TGW:3EP
vervoeder	vervoederen	WKW:TGW:1EP
vervoederde	vervoederen	WKW:VLT:1EP
vervoederd	vervoederen	WKW:VTD:ONV
vervoedert	vervoederen	WKW:TGW:3EP
vervoederde	vervoederen	WKW:VTD:VRB
vrijblijven	vrijblijven	WKW:TGW:INF
vrijbleef	vrijblijven	WKW:VLT:1EP
vrijbleven	vrijblijven	WKW:VLT:INF
vrijblijf	vrijblijven	WKW:TGW:1EP
vrijblijft	vrijblijven	WKW:TGW:3EP
vrijblijvend	vrijblijven	WKW:ODW:ONV
vrijblijvende	vrijblijven	WKW:ODW:VRB
vrijgebleven	vrijblijven	WKW:VTD:ONV
vrijgebleven	vrijblijven	WKW:VTD:VRB
gezeten	zitten	WKW:VTD:VRB
IJsselstromen	IJsselstroom	ZNW:MRV:DE_
verwreven	verwrijven	WKW:VLT:INF
verwonden	verwinden	WKW:VLT:INF
verdoken	verduiken	WKW:VLT:INF
ontvroren	ontvriezen	WKW:VLT:INF
omgaven	omgeven	WKW:VLT:INF
geleken	gelijken	WKW:VLT:INF
langsrij	langsrijden	WKW:TGW:1EP
Europees	Europees	BNW:STL:IET
Europeser	Europees	BNW:VGR:ONV
Europesere	Europees	BNW:VGR:VRB
Europesen	Europees	BNW:STL:MRV:DE_
leasend	leasen	WKW:ODW:ONV
doorvlochten	doorvlechten	WKW:VLT:INF
overlezen	overlezen	WKW:VTD:VRB
semiwatervelden	semiwaterveld	ZNW:MRV:DE_
verwond	verwonden	WKW:TGW:1EP
ANP-fotografen	ANP-fotograaf	ZNW:MRV:DE_
Ajaxlogootjes	Ajaxlogo	ZNW:MRV:VRK:DE_
