# deleted postag entries
#-------------------------------------------------------------------------------
# Do not add words here, but report them to languagetool@taaltik.nl
#-------------------------------------------------------------------------------
Fenneken	Fenneken	UNSPECIFIED
bauw	bauwen	WKW:TGW:1EP
bauwde	bauwen	WKW:VLT:1EP
bauwden	bauwen	WKW:VLT:INF
bauwt	bauwen	WKW:TGW:3EP
gebauwd	bauwen	WKW:VTD:ONV
Europese	Europese	BNW:STL:VRB
voldane	voldoen	WKW:VTD:ZNW:EKV
doorgegane	doorgaan	WKW:VTD:ZNW:EKV
ingegane	ingaan	WKW:VTD:ZNW:EKV
nagedane	nadoen	WKW:VTD:ZNW:EKV
nagegane	nagaan	WKW:VTD:ZNW:EKV
overgegane	overgaan	WKW:VTD:ZNW:EKV
paarrijden	paarrijden	WKW:TGW:INF
toegegane	toegaan	WKW:VTD:ZNW:EKV
uitgedane	uitdoen	WKW:VTD:ZNW:EKV
voorafgegane	voorafgaan	WKW:VTD:ZNW:EKV
voorbijgegane	voorbijgaan	WKW:VTD:ZNW:EKV
voorgedane	voordoen	WKW:VTD:ZNW:EKV
voorgegane	voorgaan	WKW:VTD:ZNW:EKV
voortgegane	voortgaan	WKW:VTD:ZNW:EKV
weggedane	wegdoen	WKW:VTD:ZNW:EKV
ontgane	ontgaan	WKW:VTD:ZNW:EKV
C++	C++	UNSPECIFIED
semi-waterveld	semi-waterveld	ZNW:EKV:HET
vastcontract	vastcontract	ZNW:EKV:HET
semi-watervelden	semi-waterveld	ZNW:MRV:DE_
aanstakt	aansteken	WKW:VLT:GIJ
voorlast	voorlezen	WKW:VLT:GIJ
instaakt	insteken	WKW:VLT:INF
overziene	overzien	WKW:VTD:ZNW:EKV
uitgewoven	uitwuiven	WKW:VTD:ONV
uitgewoven	uitwuiven	WKW:VTD:VRB
voorlaatst	voorlezen	WKW:VLT:GIJ
